%%%%%%%%%%%%%%%%%%%%%%%%%%%%%%%%%%%%%%%%%%%%%%
%                                           P%
%                                     o      %
%                                            %
%                       o                    %
%                                            %
%                                            %
%                                  o         %
%                        oo                  %
%                 o      oo                  %
%                                            %
%        o                                   %
%                        o                   %
%                                            %
%                                            %
%                                            %
%              o                             %
%                                 o          %
%. ooo                                       %
%%%%%%%%%%%%%%%%%%%%%%%%%%%%%%%%%%%%%%%%%%%%%%